"","run_id","response","music","correct","incorrect","total"
"1",16,"Courgette, Potato, Bread, Donut, Lemon, Orange, Raspberry, Strawberry, Cucumber, Pommegranate, Tomato, Croissant, Fries, Salmon","classical_1",14,0,14
"2",4,"Courgette, Potato, Bread, Donut, Lemon, Strawberry, Aubergine, Cucumber, Pommegranate, Apple, Tomato, Croissant, Fries, Salmon, Bell pepper","classical_1",15,0,15
"3",14,"Chocolate, Potato, Bread, Donut, Aubergine, Cucumber, Apple, Tomato, Croissant, Watermelon, Fries, Crisps","classical_1",10,2,12
"4",11,"Bread, Donut, Orange, Raspberry, Strawberry, Cucumber, Pommegranate, Tomato, Salmon","classical_1",9,0,9
"5",12,"Courgette, Potato, Bread, Donut, Lemon, Orange, Raspberry, Strawberry, Aubergine, Cucumber, Pommegranate, Apple, Tomato, Croissant, Fries, Salmon, Bell pepper","classical_1",17,0,17
"6",10,"Courgette, Potato, Bread, Donut, Strawberry, Aubergine, Cucumber, Pommegranate, Apple, Tomato, Croissant, Fries, Crisps, Salmon","classical_1",14,0,14
"7",1,"Courgette, Potato, Bread, Lemon, Orange, Strawberry, Aubergine, Cucumber, Pommegranate, Apple, Tomato, Croissant, Watermelon, Salmon, Bell pepper","classical_1",14,1,15
"8",15,"Courgette, Potato, Bread, Donut, Orange, Raspberry, Aubergine, Cucumber, Pommegranate, Apple, Tomato, Croissant, Fries, Bell pepper","classical_1",14,0,14
"9",3,"Potato, Bread, Donut, Lemon, Orange, Raspberry, Strawberry, Aubergine, Cucumber, Pommegranate, Apple, Tomato, Croissant, Fries, Crisps, Salmon, Bell pepper","classical_1",17,0,17
"10",2,"Courgette, Pineapple, Chocolate, Bread, Blueberries, Lemon, Orange, Raspberry, Strawberry, Aubergine, Cucumber, Apple, Tomato, Croissant, Watermelon, Pistachio, Mango, Bell pepper","classical_1",12,6,18
"11",5,"Courgette, Potato, Bread, Donut, Orange, Raspberry, Strawberry, Aubergine, Cucumber, Pommegranate, Apple, Tomato, Croissant, Fries, Salmon, Bell pepper","classical_1",16,0,16
"12",6,"Courgette, Potato, Bread, Donut, Lemon, Orange, Raspberry, Strawberry, Aubergine, Cucumber, Pommegranate, Apple, Tomato, Croissant, Fries, Crisps, Salmon, Bell pepper","classical_1",18,0,18
"13",7,"Potato, Donut, Blueberries, Orange, Apple, Tomato","classical_1",5,1,6
"14",8,"Potato, Bread, Donut, Orange, Raspberry, Aubergine, Cucumber, Pommegranate, Tomato, Salmon, Bell pepper","classical_1",11,0,11
"15",9,"Courgette, Potato, Avocado, Bread, Donut, Lemon, Orange, Strawberry, Aubergine, Cucumber, Pommegranate, Apple, Tomato, Croissant, Crisps, Salmon, Bell pepper","classical_1",16,1,17
"16",16,"Bee, Fire, Volcano, Lion, Polar bear, Parrot, Helicopter, Moon, Butterfly","metal_1",8,1,9
"17",4,"Clownfish, Fire, Flower, Elephant, Volcano, Lion, Polar bear, Rainbow, Parrot, Helicopter, Moon, Tree, Dolphin, Butterfly","metal_1",12,2,14
"18",14,"Bee, Flower, Elephant, Volcano, Polar bear, Rainbow, Parrot, Helicopter, Thunder, Boat, Moon, Tree, Dolphin, Butterfly","metal_1",10,4,14
"19",11,"Clownfish, Elephant, Volcano, Lion, Rainbow, Parrot, Helicopter, Thunder, Boat, Dolphin, Ant","metal_1",8,3,11
"20",12,"Clownfish, Bee, Fire, Flower, Elephant, Volcano, Lion, Polar bear, Rainbow, Parrot, Helicopter, Boat, Moon, Tree, Dolphin, Butterfly, Ant","metal_1",13,4,17
"21",10,"Clownfish, Bee, Fire, Tiger, Elephant, Polar bear, Rainbow, Thunder, Moon, Waterfall, Rain","metal_1",5,6,11
"22",1,"Clownfish, Tiger, Elephant, Volcano, Lion, Polar bear, Rainbow, Moon, Tree, Beach, Dolphin, Butterfly, Rain","metal_1",9,4,13
"23",15,"Clownfish, Bee, Fire, Flower, Volcano, Lion, Polar bear, Parrot, Helicopter, Thunder, Boat, Moon, Dolphin, Butterfly","metal_1",9,5,14
"24",3,"Clownfish, Bee, Fire, Flower, Elephant, Volcano, Lion, Polar bear, Rainbow, Parrot, Helicopter, Thunder, Boat, Moon, Tree, Dolphin, Butterfly, Ant","metal_1",13,5,18
"25",2,"Bee, Cat, Fire, Eagle, Flower, Tiger, Elephant, Volcano, Lion, Shark, Polar bear, Rainbow, Parrot, Thunder, Boat, Snow, Moon, Tree, Rain","metal_1",9,10,19
"26",5,"Clownfish, Elephant, Lion, Polar bear, Rainbow, Helicopter, Thunder, Boat, Tree, Dolphin","metal_1",7,3,10
"27",6,"Clownfish, Fire, Tiger, Elephant, Volcano, Polar bear, Rainbow, Parrot, Thunder, Tree, Dolphin, Butterfly","metal_1",9,3,12
"28",7,"Lion, Polar bear, Rainbow, Parrot, Helicopter, Moon, Dolphin, Butterfly","metal_1",8,0,8
"29",8,"Clownfish, Bee, Fire, Flower, Volcano, Lion, Polar bear, Rainbow, Parrot, Helicopter, Thunder, Boat, Tree, Dolphin, Butterfly, Ant","metal_1",11,5,16
"30",9,"Clownfish, Bee, Flower, Elephant, Volcano, Shark, Polar bear, Rainbow, Parrot, Helicopter, Thunder, Boat, Moon, Dolphin, Butterfly, Ant","metal_1",10,6,16
"31",16,"Heart, Liver, Bone, Muscle, Stethoscope, Brain, Medication, Coat, Vaccin, Blood, Gloves, Alcohol, Wheelchair, Hospital, Virus","metal_2",14,1,15
"32",4,"Heart, Liver, Bone, Muscle, Stethoscope, Brain, Medication, Vaccin, Blood, Gloves, Injury, Coffee, Scissors, Alcohol, Wheelchair, Hospital, Virus","metal_2",17,0,17
"33",14,"Heart, Liver, Bone, Brain, Bladder, Medication, Gloves, Injury, Coffee, Alcohol, Wheelchair, Hospital, Virus","metal_2",12,1,13
"34",11,"Heart, Liver, Bone, Muscle, Stethoscope, Medication, Coat, Injury, EEG, Virus","metal_2",8,2,10
"35",12,"Heart, Liver, Bone, Muscle, Stethoscope, Brain, Medication, Vaccin, Blood, Gloves, Injury, Coffee, Scissors, Alcohol, Wheelchair, Hospital, Virus","metal_2",17,0,17
"36",10,"Heart, Liver, Bone, Muscle, Brain, Medication, Coat, Gloves, Coffee, Alcohol, Wheelchair, Hospital, Bandage","metal_2",11,2,13
"37",1,"Heart","metal_2",1,0,1
"38",15,"Heart, Brain, Medication, Vaccin, Nerves, Gloves, Scissors, Virus, Bandage","metal_2",7,2,9
"39",3,"Heart, Liver, Bone, Muscle, Stethoscope, Brain, Medication, Coat, Vaccin, Gloves, Injury, Coffee, Scissors, Alcohol, Wheelchair, Hospital, Virus","metal_2",16,1,17
"40",2,"Heart, Bone, Stethoscope, Kidney, Brain, Medication, Coat, Intestines, Vaccin, Nerves, Blood, Surgery, Gloves, CPR, Brokenbone, Coffee, Scissors, Wheelchair, Hospital, Virus","metal_2",13,7,20
"41",5,"Muscle, Stethoscope, Gloves, Injury, Coffee, Wheelchair, Hospital","metal_2",7,0,7
"42",6,"Heart, Liver, Bone, Stethoscope, Brain, Blood, Gloves, Injury, Coffee, Scissors, Alcohol, Wheelchair, Hospital, Bandage","metal_2",13,1,14
"43",7,"Brain, Intestines, EEG, MRI","metal_2",1,3,4
"44",8,"Heart, Liver, Bone, Muscle, Stethoscope, Medication, Vaccin, Blood, Gloves, Coffee, Scissors, Alcohol, Wheelchair, Hospital, Virus","metal_2",15,0,15
"45",9,"Heart, Liver, Muscle, Kidney, Brain, Intestines, Blood, Surgery, Brokenbone, Coffee, Alcohol, Virus, Bandage","metal_2",8,5,13
"46",16,"Desk, Spatula, Washing machine, Lamp, Tape, Bottle, Glass, Mixer, Mirror, Curtains, Pillow","classical_2",9,2,11
"47",4,"Bed, Desk, Cutlery, Toilet, Lamp, Sink, Glass, Mixer, Mirror, Curtains, Blanket, Pillow","classical_2",11,1,12
"48",14,"Bed, Spatula, Lamp, Pan, Tape, Bottle, Mixer, Blanket, Pillow","classical_2",8,1,9
"49",11,"Bed, Cutlery, Lamp, Pan, Pot, Bottle, Glass, Pillow","classical_2",8,0,8
"50",12,"Bed, Spatula, Cutlery, Toilet, Lamp, Sink, Window, Pot, Bottle, Chair, Mirror, Curtains, Pillow","classical_2",10,3,13
"51",10,"Bed, Desk, Spatula, Cutlery, Lamp, Sink, Pan, Pot, Bottle, Glass, Mixer, Mirror, Curtains","classical_2",13,0,13
"52",1,"Bed, Desk, Spatula, Cutlery, Pan, Pot, Bottle, Oven, Mixer, Chair","classical_2",8,2,10
"53",15,"Bed, Desk, Cutlery, Toilet, Lamp, Pot, Bottle, Glass, Hanger, Curtains, Blanket, Pillow","classical_2",10,2,12
"54",3,"Bed, Desk, Spatula, Cutlery, Bag, Lamp, Sink, Pan, Window, Pot, Bottle, Glass, Mixer, Mirror, Curtains","classical_2",13,2,15
"55",2,"Bed, Desk, Wardrobe, Spatula, Washing machine, Cutlery, Lamp, Window, Pot, Bottle, Glass, Hanger, Chair, Fridge, Mirror, Curtains, Blanket, Pillow","classical_2",12,6,18
"56",5,"Bed, Desk, Spatula, Pan, Bottle, Mixer","classical_2",6,0,6
"57",6,"Bed, Desk, Spatula, Cutlery, Toilet, Lamp, Pan, Bottle, Glass, Fridge, Mirror","classical_2",9,2,11
"58",7,"Desk, Cutlery, Pan, Pot, Mixer","classical_2",5,0,5
"59",8,"Bed, Desk, Cutlery, Toilet, Sink, Pan, Bottle, Oven, Glass, Mixer, Chair, Fridge, Pillow","classical_2",9,4,13
"60",9,"Bed, Spatula, Cutlery, Toilet, Bottle, Toothbrush, Hanger, Mirror, Pillow","classical_2",6,3,9
